11111111111111111111111111111111111111111111111111
10000000000000000001000100010000000000000100000001
10000001000000000001010001000100000000400100111001
10070011100000000001011111111100000000000101111101
10000111110000000041010000000100000300000101313101
10001111111111111111010006000100000000000101111101
10000000000000000000010000000100400000000100181001
11111111111110011111111100011100000000000100101001
10000000001100001000110000000111111111111110000011
10011111001000010000100000000100010001000111101111
10100000101000010100100000000101000100014100101001
10100000101000100101000000000100010001000100050001
10100400100000500100000004000101000100010160101061
10100000101000100101000000000100010001000111101111
10100000101000010100100000000101000100010100151001
10011111001000010000100000000100010001000101101101
10000000001100001000110000000101000100010101000101
11111011111111111111111100011100010701000101000101
10100000101000000000000000000101000100010111151111
10001010001011111111111100011100010001000101101101
10100000101000000000111001001101000100010100000001
10000100001010000010110011100100010001000111000111
11001110011000010000100111110000000100010101151101
10000000001000000000100000000000000001000100000001
10000300001001030100100000000000000000010100000001
10001010001000000000100000000000000001111101111111
10001010001000010040100000000000000001000101000001
10011011001010000010100000000000000005030001010201
10110601101000000000100000000000000001000100010001
11111111111111111111111111111111111111111111111111